11111111111111
1P000010000001
110CC0CCC01101
10011C111C1C01
100000111E0011
11111111111111
