11111111111111
1P000000000C01
11111100000C11
111CCCCCCCCC11
11111111111C11
11111111111C11
1111111111CE11
11111111111111
