1111111111
1P00100CE1
1CCC1C0C11
1111111111
