1111111111
1P000000E1
1CCC1C1C11
1XXXXXXXX1
1111111111


