1111111111
1PCCCC00E1
1CCC1C0011
1111111111
