1111111111
1P000000E1
1CCC1C0C11
1111111111
