11111111111111111111111111
10000000000000000000C00001
10000010000000000000000001
1000001C000000000000000001
10E00011111111111110000001
10000010000000000000C00001
10000010000CCCCCCCC0000001
10P00010000C00000C00000001
10000000000CCCCCCC00000001
11111111111111111111111111
