11111111111111111111111111
10000000000000X00000C00001
1000001000000XXXX000000001
1000001C111111110000000001
10E00011111111111110000001
10000010000000000000C00001
100X0010000CCCCCCCCX000001
10P00010000CXXXXXXXC000001
10000000000CCCCCCCXX000001
11111111111111111111111111
