111111111111111111
100000CC0011111EP1
111111111111111111