11111111111111111
1P1111111111CC111
10100000000000111
10101C111XXX00111
10101CC1111100111
100011101111000E1
11111111111101111
