11111111111111
100000000C0C11
1PCCCC00010C11
11101111110C01
1C000100000CE1
11111111111111
